+-------------------------------------------------------------------------------------------------------------------------------------------------------------------------------------------------------------------------+
|                                                                                                                                                                                                                         |
|                                              |\___   ___\\  ___ \ |\   __  \|\   _ \  _   \|\  \|\   ___  \|\   __  \|\  \             |\  \|\   ___ \|\  \     |\  ___ \                                               |
|                                              \|___ \  \_\ \   __/|\ \  \|\  \ \  \\\__\ \  \ \  \ \  \\ \  \ \  \|\  \ \  \            \ \  \ \  \_|\ \ \  \    \ \   __/|                                              |
|                                                   \ \  \ \ \  \_|/_\ \   _  _\ \  \\|__| \  \ \  \ \  \\ \  \ \   __  \ \  \            \ \  \ \  \ \\ \ \  \    \ \  \_|/__                                            | 
|                                                    \ \  \ \ \  \_|\ \ \  \\  \\ \  \    \ \  \ \  \ \  \\ \  \ \  \ \  \ \  \____        \ \  \ \  \_\\ \ \  \____\ \  \_|\ \                                           |
|                                                     \ \__\ \ \_______\ \__\\ _\\ \__\    \ \__\ \__\ \__\\ \__\ \__\ \__\ \_______\       \ \__\ \_______\ \_______\ \_______\                                          |
|                                                      \|__|  \|_______|\|__|\|__|\|__|     \|__|\|__|\|__| \|__|\|__|\|__|\|_______|        \|__|\|_______|\|_______|\|_______|                                          |
|                                                                                                                                                                                                                         |
+-------------------------------------------------------------------------------------------------------------------------------------------------------------------------------------------------------------------------+
|                                                                                                                                                                                                                         |
|                                                                                              [1] INICIALIZAR JOGO                                                                                                       |
|                                                                                              [2] RECONECTAR SAVE                                                                                                        |                                                                                                            |
|                                                                                              [3] ENCERRAR PROCESSO                                                                                                      |
|                                                                                                                                                                                                                         |
+-------------------------------------------------------------------------------------------------------------------------------------------------------------------------------------------------------------------------+                                                                                                                                                                                                                         |
|                                                                                                                                                                                                                         |
|  STATUS: OFFLINE                                                                                                                                                                                  VERSÃO: 0.0.1 (ALPHA) |                                          
|                                                                                                                                                                                                                         |
+-------------------------------------------------------------------------------------------------------------------------------------------------------------------------------------------------------------------------+